Ozone=tencentqq
Foursquare=foursquare
Vkontakte=vk
Weibo=sinaweibo
Telegram=telegram
Pixelfed=pixelfed
Workplace=workplace
X=x
Threads=threads
Mail.Ru=maildotru
Hacker News=ycombinator
TikTok=tiktok
Facebook=facebook
Last.fm=lastdotfm
LinkedIn=linkedin
Dribbble=dribbble
reddit=reddit
Flickr=flickr
GitHub=github
Pinterest=pinterest
Skyrock=skyrock
StackOverflow=stackoverflow
Bluesky=bluesky
LiveJournal=livejournal
V2EX=v2ex
Douban=douban
Renren=renren
tumblr=tumblr
Snapchat=snapchat
Badoo=badoo
YouTube=youtube
Instagram=instagram
Viadeo=viadeo
Odnoklassniki=odnoklassniki
Vimeo=vimeo
Mastodon=mastodon
Sourceforge=sourceforge
Twitch=twitch
XING=xing
Google=google
DuckDuckGo=duckduckgo